5555555555
5555555555
----------
3-4-0----3
1211111221
5555555555
5555555555
5555555555