1111111--1
5--------5
5-11111215
53---0---5
51111112-5
53----4--5
5111111--5
5555555--5