3-----1111
11114-----
---51-----
---0------
---222----
----------
---------3
11111-1111
