----------
-11-----3-
-----0-112
----12255-
1----555--
511-----4-
555-31111-
55511555--