---1------
---5-11111
---5---555
---511--55
-----3--55
-4---11255
1111-0-3--
55551111-1