----------
---34-----
--11111---
----------
---0------
111111-2--
555555--3-
5555551111