----------
----------
----------
----------
-4-0------
1111112121
5555555555
5555555555