----------
-----3----
1111112---
----------
-4-111-0-3
1115551211
5555555555
5555555555