1--------1
5-3--0---5
5111111215
5-3----4-5
5111111115
5555555555
5555555555
5555555555