3-----1111
11114-----
----1-----
---0------
---221----
---------3
------1111
1111115555
