----------
----------
----------
-0--4-----
1111111211
5555555555
5555555555
5555555555