----------
----------
----------
3-04-----3
1211111121
5555555555
5555555555
5555555555